CONSEIL: أسمع كلام اللي يبكيك وماتسمعش كلام اللي يضحكك
MODERATION: إذا صاحبك عسل ما تلحسوش الكل
SAGESSE: إسأل مجرب ولا تسأل طبيب
PRUDENCE: اللي خاف نجى
GENEROSITE: أعمل الخير وارمي في البحر
ADAPTATION: أعمل كيف جارك وإلا حول باب دارك
COURAGE: اللي يخاف من العفريت يطلع له
PREVENTION: شد مشومك لا يجيك ما اشوم
SANTE: الصحة تاج على رؤوس الأصحاء
PATIENCE: اللي ينام عالجرح يلاقي الربح
BIENETRE: العقل السليم في الجسم السليم
RICHESSE: اللي عندو ما يموتش
DETTE: اللي عليه مليان، راهو خسران
SATISFACTION: القناعة كنز لا يفنى
METEO: اللي ما عندوش مطر، يستنا الندى
AGRICULTURE: اللي يزرع حصاد
PERSEVERANCE: الصبر مفتاح الفرج
EDUCATION: اللي يربّي العود يربّي الحصاد
FAMILLE: اليد الواحدة ما تصفقش
TEMPS: الوقت اللي ما يقدّرش يقدّرك
AGE: الكبير كبير ولو طار
JEUNESSE: اللي يستعجل ياكل خبز حار
EXPERIENCE: الوقت شيخ
OPPORTUNITE: اللي يغامر يربح
NAVIGATION: المركب اللي ما تهزّش ما تمشّيش
PECHE: اللي يخاف من الموج ما يفرشش
AMITIE: إسأل على صاحبك إستغناش أما الطبيعة هي هي
OPPORTUNISME: البقرة كيف اتطيح تكثر اسكاكينها
ESPOIR_DECU: عاش يتمني في عنبة مات جابولو عرجون
TRAHISON: جا يعاون فيه على قبر بوه هربلو بالفاس
REVANCHE: الّي يبيعك بالفول بيعو بالقشور
INJUSTICE: عريان يسلب في ميت
DESTINEE: الي ليك لك و الي خاطيك خاطيك
ECHEC: جا يكحلها عماها
VERITE: اللي فيه طبة عمرها ماتتخبى
AUTOJUSTIFICATION: ضربو على قرعتو قال شعري طاح
HERITAGE: ولد الفار يطلع حفار
FOLIE: مهبولة و زغرتولها في وذنها
OUBLI: ملي دفنوه مازاروه
NOSTALGIE: اللي يبدل لحية بلحية يجي نهار يشتاقهم لثنين
COINCIDENCE: فردة ولقات اختها
ABUS: اللي يكثر مالعسل يمصاط
IRONIE: قلو يقوي سعدك قلو توة توة
CONTRASTE_ACTIONS: أعملْ الخير وأنساه واعْمل الشّر وتفكره
RELIGION_TRAVAIL: أعمِلْ الفرض وانقب الأرض
IMITATION: أعمِلْ كيف جارك وإلا حول باب دارك
FIERTE: إللّي يعْرف عِزَو كلام الناس ما يهزو